'부산행'을	' 부 산 행 ' 을
감독은	감 도 근
감독의	감 도 긔
감독이	감 도 기
그	그
그런데	그 런 데
기대를	기 대 를
너무	너 무
대해서	대 해 서
만든	만 든
만들기	만 들 기
만들었어요.	만 드 러 써 요 .
많이	마 니
봤어요.	봐 써 요 .
새로운	새 로 운
실사	실 사
않아요.	아 나 요 .
애니메이션	애 니 메 이 션
애니메이션을	애 니 메 이 셔 늘
연상호	연 상 호
영화	영 화
영화는	영 화 는
영화들이	영 화 드 리
영화를	영 화 를
영화에	영 화 에
영화예요.	영 화 예 요 .
원래	월 래
이	이
이번에	이 버 네
재미있었어요.	재 미 이 써 써 요 .
저는	저 는
전에는	저 네 는
정말	정 말
좀비	좀 비
좋아서,	조 아 서 ,
좋아하지	조 아 하 지
처음으로	처 으 므 로
항상	항 상
했어요.	해 써 요 .
